24 5
HNHNHNHNHNHNHNHNHNHNHNN
HHHHHHHHHHHNNNNNNNNNNNN
NNNNNNNNNNNNNNNNNNNNNNN
NNNNNNUUNNNNNNNNNNNNNNN
NNNNUUUUNNNNNNNNNNNNNNN