12 6
HHHHHHHHHHH
HHHHHHHHHHH
NNNNNNNNNNN
NNNNNNUUNNN
NNNNUUUUNNN